E.....E.....E
.............
.BB.BBBBB.BB.
.B...B.B...B.
.B.B.....B.B.
...B.SSS.B...
.BB.S...S.BB.
...B.SSS.B...
.B.B.....B.B.
.B...B.B...B.
.BB.BBBBB.BB.
.....BBB.....
...P.BAB.....
