E.....E.....E
.............
.SSS.....SSS.
.S.........S.
.S..BBBBB..S.
....B...B....
....B...B....
....B...B....
.S..BBBBB..S.
.S.........S.
.SSS.....SSS.
.....BBB.....
...P.BAB.....
