E.....E.....E
.B.B.B.B.B.B.
.B.B.B.B.B.B.
...FFF.FFF...
SS.BB.B.BB.SS
..II.....II..
..S.SS.SS.S..
..II.....II..
SS.BB.B.BB.SS
...FFF.FFF...
.B.B.B.B.B.B.
.....BBB.....
...P.BAB.....
