E.....E.....E
.B.B.B.B.B.B.
.B.B.B.B.B.B.
.............
SS.BB.B.BB.SS
.............
..S.SS.SS.S..
.............
SS.BB.B.BB.SS
.............
.B.B.B.B.B.B.
.....BBB.....
...P.BAB.....
