E.....E.....E
SS.........SS
SS....B....SS
...BB...BB...
...B.....B...
..B...B...B..
......B......
..B...B...B..
...B.....B...
...BB...BB...
SS....B....SS
SS...BBB...SS
...P.BAB.....
