E.....E.....E
..S.......S..
.SSS...SSS...
.S.......S...
....BBBBB....
....B...B....
..S.B...B.S..
....B...B....
....BBBBB....
.S.......S...
.SSS...SSS...
.....BBB.....
...P.BAB.....
