E.....E.....E
..S.......S..
.SSS...SSS...
.S.......S...
....WWWWW....
....W...W....
..S.W...W.S..
....W...W....
....WWWWW....
.S.......S...
.SSS...SSS...
.....BBB.....
...P.BAB.....
