E.....E.....E
.BB.BB.BB.BB.
.BB.BB.BB.BB.
.............
BB.BB.B.BB.BB
.............
.S.S.S.S.S.S.
.............
BB.BB.B.BB.BB
.............
.BB.BB.BB.BB.
.....BBB.....
...P.BAB.....
