E.....E.....E
.S.S.S.S.S.S.
.............
.BBB.BBB.BBB.
.............
.BBB.BBB.BBB.
.............
.BBB.BBB.BBB.
.............
.BBB.BBB.BBB.
.............
.....BBB.....
...P.BAB.....
