E.....E.....E
.III.III.III.
.SSS.SSS.SSS.
.III.III.III.
.BB.SS.SS.BB.
.............
.SS.S.B.S.SS.
.............
.BB.SS.SS.BB.
.III.III.III.
.SSS.SSS.SSS.
.....BBB.....
...P.BAB.....
