E.....E.....E
.............
.SSS.SSS.SSS.
.............
.BB.SS.SS.BB.
.............
.SS.S.B.S.SS.
.............
.BB.SS.SS.BB.
.............
.SSS.SSS.SSS.
.....BBB.....
...P.BAB.....
