E.....E.....E
.............
BB.B.BBB.B.BB
.............
.S.SSS.SSS.S.
.............
.B.B.B.B.B.B.
.............
.S.SSS.SSS.S.
.............
BB.B.BBB.B.BB
.....BBB.....
...P.BAB.....
