E.....E.....E
S.S.S.S.S.S.S
.............
.BBB.BBB.BBB.
.FFF.FFF.FFF.
.SSS.SSS.SSS.
.............
.BBB.BBB.BBB.
.FFF.FFF.FFF.
.SSS.SSS.SSS.
.............
.....BBB.....
...P.BAB.....
