E.....E.....E
.B.B.B.B.B.B.
.B.B.B.B.B.B.
.............
BB.BB.B.BB.BB
.............
.SS.S.B.S.SS.
.............
BB.BB.B.BB.BB
.............
.B.B.B.B.B.B.
.....BBB.....
...P.BAB.....
