E.....E.....E
.............
.SSSSS.SSSSS.
.S.........S.
.S.B.BBB.B.S.
.S.........S.
..B.SSSSS.B..
.S.........S.
.S.B.BBB.B.S.
.S.........S.
.SSSSS.SSSSS.
.....BBB.....
...P.BAB.....
