E.....E.....E
BB.B.B.B.B.BB
...WW.WW.WW..
.SS.SS.SS.SS.
.............
B.B.B.B.B.B.B
.............
.SS.SS.SS.SS.
..WW.WW.WW...
BB.B.B.B.B.BB
.............
.....BBB.....
...P.BAB.....
