E.....E.....E
.S.S.S.S.S.S.
.B.B.B.B.B.B.
.............
SS.SSS.SSS.SS
.............
.B.B.B.B.B.B.
.............
SS.SSS.SSS.SS
.............
.B.B.B.B.B.B.
.....BBB.....
...P.BAB.....
