E.....E.....E
.............
.BSB.BSB.BSB.
.............
.BSB.BSB.BSB.
.............
.SBS.SBS.SBS.
.............
.BSB.BSB.BSB.
.............
.BSB.BSB.BSB.
.....BBB.....
...P.BAB.....
