E.....E.....E
.SS.SS.SS.SS.
.............
.SS.SS.SS.SS.
.............
.BB.BB.BB.BB.
.............
.SS.SS.SS.SS.
.............
.BB.BB.BB.BB.
.............
.....BBB.....
...P.BAB.....
