E.....E.....E
S.S.S.S.S.S.S
.B.B.B.B.B.B.
.............
.SBS.SBS.SBS.
.............
BB.B.B.B.B.BB
.............
.SBS.SBS.SBS.
.............
.B.B.B.B.B.B.
.....BBB.....
...P.BAB.....
