E.....E.....E
.SSS.SSS.SSS.
.S.S.S.S.S.S.
.SSS.SSS.SSS.
.III.III.III.
.SBS.SBS.SBS.
.III.III.III.
.SSS.SSS.SSS.
.S.S.S.S.S.S.
.SSS.SSS.SSS.
..FF.FFF.FF..
.....BBB.....
...P.BAB.....
