E.....E.....E
.SSS.SSS.SSS.
.S.S.S.S.S.S.
.SSS.SSS.SSS.
.............
.SBS.SBS.SBS.
.............
.SSS.SSS.SSS.
.S.S.S.S.S.S.
.SSS.SSS.SSS.
.............
.....BBB.....
...P.BAB.....
